Here are the capitals of all 44 countries widely recognized as part of Europe:

**Western Europe:**

* Andorra: Andorra la Vella
* Austria: Vienna
* Belgium: Brussels
* France: Paris
* Germany: Berlin
* Ireland: Dublin
* Luxembourg: Luxembourg City
* Monaco: Monaco
* Netherlands: Amsterdam
* Switzerland: Bern
* United Kingdom: London

**Northern Europe:**

* Denmark: Copenhagen
* Finland: Helsinki
* Iceland: Reykjavik
* Norway: Oslo
* Sweden: Stockholm

**Eastern Europe:**

* Belarus: Minsk
* Bulgaria: Sofia
* Czech Republic: Prague
* Hungary: Budapest
* Moldova: Chișinău
* Poland: Warsaw
* Romania: Bucharest
* Russia (European part): Moscow
* Slovakia: Bratislava
* Ukraine: Kyiv

**Southern Europe:**

* Albania: Tirana
* Bosnia and Herzegovina: Sarajevo
* Croatia: Zagreb
* Greece: Athens
* Italy: Rome
* Kosovo: Pristina
* Montenegro: Podgorica
* North Macedonia: Skopje
* Portugal: Lisbon
* San Marino: San Marino
* Serbia: Belgrade
* Spain: Madrid
* Vatican City: Vatican City

**Note:** Some countries, like Russia and Turkey, span both Europe and Asia.  The capitals listed are the primary administrative centers located within their European territories.


Let me know if you have any other questions about European geography!

